11111111
1P000101
10001E11
1C000101
11111111