1111111111111111111111111111111111
1000100C0000111000C0000100001111C1
100C110000000100000000001010011101
111000C0000000001000010001111010E1
1P000000001100000000000000000000C1
100000000011000000C000000C00010001
1000010000000001000000011111110001
10C111000C000000010000000101000C01
1010010100000110000000000010000001
1111111111111111111111111111111111